NO textures/barrel.xpm
SO textures/bluestone.xpm
WE textures/colorstone.xpm
EA textures/eagle.xpm
F 10,225,11
C 225,10,2

11111
1N001
10001
100W1
11111
