NO textures/barrel.xpm
SO textures/bluestone.xpm
WE textures/colorstone.xpm
EA textures/eagle.xpm
F 10,225,11
C 225,,2

11111
10001
10N01
10001
11111
