NO textures/barrel.xpm
SO textures/bluestone.xpm
WE textures/colorstone.xpm
EA textures/eagle.xpm
F 186,235,52
C 52,171,235



1111111111111111111111111111111111111111
1111111111111111111111111111111111111111
1111111111000000011111111111111111111111
1111111110000011001111111111111111111111
1111111100001111111111111111111111111111
1111111000011111111111111111111111111111
1111111000111111111110111001111111111111
1111111000111111111110000011111111111111
1111110000111111111000000111111111111111
1111111000111111111110000011111111111111
1111111000111111111110111001111111111111
11111110W0011111111111111111111111111111
1111111100001111111111111111111111111111
1111111110000011001111111111111111111111
1111111111000000011111111111111111111111
1111111111111111111111111111111111111111
1111111111111111111111111111111111111111