NO textures/carrot.xpm
SO textures/rabbit.xpm
WE textures/colorstone.xpm
EA textures/eagle.xpm

F 220,100,0
C 225,30,0

111111111111
100000000101
100001000S01
100010100001
100100010101
100010100001
100001000001
111111111111